{
  "backgroundColor": "darkseagreen",
  "map": [
    [2, 1, 1, 2, 0, 0, 0, 0, 2, 2],
    [1, 0, 0, 0, 1, 0, 0, 1, 1, 1],
    [1, 0, 0, 0, 0, 0, 0, 0, 0, 1],
    [0, 1, 0, 0, 0, 0, 5, 5, 0, 0],
    [0, 0, 0, 0, 0, 0, 0, 0, 0, 0],
    [0, 1, 0, 0, 0, 0, 0, 0, 0, 0],
    [1, 1, 0, 0, 0, 0, 1, 0, 0, 1],
    [1, 0, 0, 0, 1, 0, 0, 0, 0, 1],
    [0, 1, 0, 0, 0, 0, 0, 1, 3, 3],
    [2, 2, 0, 0, 0, 0, 1, 1, 3, 3]
  ],
  "exits": {
    "north": "room3",
    "south": "room11",
    "east": "room8",
    "west": "room6"
  },
  "objects": {
    "1": "Grass",
    "2": "Tree",
    "3": "Water",
    "4": "Rock",
    "5": "Slime"
  }
}