{
  "backgroundColor": "darkseagreen",
  "map": [
    [2, 2, 2, 2, 2, 2, 2, 2, 2, 3],
    [0, 0, 0, 0, 1, 0, 0, 1, 2, 3],
    [0, 0, 0, 0, 0, 0, 0, 0, 2, 3],
    [0, 1, 0, 0, 0, 0, 0, 0, 2, 3],
    [0, 0, 0, 5, 0, 0, 0, 0, 0, 3],
    [0, 1, 0, 0, 0, 0, 0, 0, 0, 3],
    [0, 1, 0, 0, 0, 0, 1, 0, 0, 3],
    [0, 0, 0, 0, 1, 0, 0, 1, 0, 3],
    [0, 1, 1, 0, 0, 0, 0, 0, 1, 3],
    [2, 1, 1, 2, 0, 0, 0, 0, 2, 3],
  ],
  "exits": {
    "west": "room3",
    "south": "room8"
  },
  "objects": {
    "1": "Grass",
    "2": "Tree",
    "3": "Water",
    "4": "Rock",
    "5": "Slime"
  }
}