{
  "backgroundColor": "darkseagreen",
  "map": [
    [2, 1, 1, 2, 0, 0, 0, 0, 2, 2],
    [2, 0, 0, 0, 1, 0, 0, 1, 1, 1],
    [2, 0, 0, 0, 0, 0, 0, 0, 0, 1],
    [0, 1, 0, 0, 0, 0, 0, 0, 0, 0],
    [0, 0, 0, 0, 0, 0, 0, 0, 3, 0],
    [1, 1, 0, 0, 0, 0, 0, 1, 3, 0],
    [1, 1, 0, 0, 0, 0, 1, 3, 3, 1],
    [0, 0, 0, 0, 1, 0, 0, 3, 3, 1],
    [0, 1, 0, 0, 0, 0, 0, 3, 3, 0],
    [2, 2, 2, 2, 2, 2, 2, 2, 2, 2],
  ],
  "exits": {
    "north": "room2",
    "south": "room10",
    "east": "room7",
    "west": "room5"
  },
  "objects": {
    "1": "Grass",
    "2": "Tree",
    "3": "Water",
    "4": "Rock",
    "5": "Slime"
  }
}