{
  "backgroundColor": "darkseagreen",
  "map": [
    [2, 1, 0, 0, 2, 2, 0, 1, 3, 3],
    [2, 0, 0, 0, 1, 0, 0, 1, 0, 2],
    [2, 0, 0, 0, 0, 0, 0, 0, 0, 2],
    [0, 0, 0, 0, 0, 0, 0, 0, 0, 0],
    [0, 0, 0, 0, 5, 0, 0, 0, 5, 0],
    [0, 0, 0, 0, 0, 0, 0, 0, 0, 1],
    [0, 0, 0, 0, 0, 0, 1, 0, 0, 1],
    [0, 2, 0, 0, 1, 0, 0, 1, 0, 0],
    [0, 0, 0, 0, 0, 0, 0, 0, 1, 0],
    [4, 4, 4, 4, 4, 4, 4, 4, 4, 4]
  ],
  "exits": {
    "north": "room11",
    "east": "room16",
    "west": "room14"
  },
  "objects": {
    "1": "Grass",
    "2": "Tree",
    "3": "Water",
    "4": "Rock",
    "5": "Slime"
  }
}