{
  "backgroundColor": "darkseagreen",
  "map": [
    [3, 2, 0, 0, 0, 0, 1, 1, 0, 3],
    [3, 0, 0, 0, 1, 0, 0, 1, 0, 3],
    [3, 1, 0, 0, 0, 0, 0, 0, 3, 3],
    [3, 1, 0, 0, 0, 0, 0, 0, 3, 3],
    [3, 2, 0, 0, 0, 0, 0, 1, 3, 3],
    [3, 1, 0, 0, 0, 0, 0, 0, 3, 3],
    [3, 1, 0, 0, 0, 0, 1, 0, 3, 3],
    [3, 2, 0, 0, 1, 0, 0, 1, 3, 3],
    [3, 1, 0, 0, 0, 0, 0, 0, 4, 3],
    [3, 1, 0, 0, 2, 2, 0, 1, 0, 3]
  ],
  "exits": {
    "north": "room8",
    "south": "room16"
  },
  "objects": {
    "1": "Grass",
    "2": "Tree",
    "3": "Water",
    "4": "Rock",
    "5": "Slime"
  }
}