{
  "backgroundColor": "darkseagreen",
  "map": [
    [3, 1, 0, 0, 2, 2, 0, 1, 0, 3],
    [2, 0, 0, 0, 1, 0, 0, 1, 0, 3],
    [2, 2, 0, 0, 0, 0, 0, 0, 0, 3],
    [0, 1, 0, 0, 0, 0, 0, 0, 3, 3],
    [0, 0, 0, 0, 0, 0, 0, 0, 3, 3],
    [1, 0, 0, 0, 0, 0, 0, 0, 3, 3],
    [1, 0, 0, 0, 0, 0, 1, 0, 3, 3],
    [0, 2, 0, 0, 1, 0, 0, 1, 3, 3],
    [0, 0, 0, 0, 0, 0, 0, 3, 3, 3],
    [4, 4, 4, 4, 4, 4, 4, 3, 3, 3]
  ],
  "exits": {
    "north": "room12",
    "west": "room15"
  },
  "gameCondition": {
    "type": "NPC",
    "name": "Troll",
    "condition": "trollAlive"
  },
  "objects": {
    "1": "Grass",
    "2": "Tree",
    "3": "Water",
    "4": "Rock",
    "5": "Slime"
  }
}