{
  "backgroundColor": "darkseagreen",
  "map": [
    [2, 2, 0, 0, 0, 0, 0, 2, 2, 2],
    [2, 0, 0, 0, 1, 0, 0, 1, 0, 2],
    [2, 0, 0, 0, 0, 0, 0, 0, 0, 2],
    [0, 1, 0, 0, 0, 0, 0, 0, 0, 0],
    [0, 0, 0, 0, 0, 0, 0, 0, 0, 0],
    [0, 1, 0, 0, 0, 0, 0, 0, 0, 1],
    [0, 1, 0, 0, 0, 0, 1, 0, 0, 1],
    [0, 2, 0, 0, 1, 0, 0, 0, 0, 0],
    [0, 0, 0, 0, 0, 0, 0, 1, 0, 0],
    [4, 4, 4, 4, 4, 4, 4, 4, 4, 4]
  ],
  "exits": {
    "north": "room10",
    "east": "room15",
    "west": "room13"
  },
  "objects": {
    "1": "Grass",
    "2": "Tree",
    "3": "Water",
    "4": "Rock",
    "5": "Slime"
  }
}