{
  "backgroundColor": "darkseagreen",
  "map": [
    [2, 2, 2, 2, 2, 2, 2, 2, 2, 2],
    [2, 2, 2, 2, 0, 0, 0, 0, 2, 2],
    [0, 1, 0, 5, 2, 2, 2, 1, 0, 0],
    [0, 0, 0, 0, 1, 0, 0, 0, 0, 0],
    [0, 0, 0, 1, 2, 0, 1, 1, 1, 0],
    [0, 1, 0, 1, 2, 0, 1, 1, 5, 0],
    [0, 2, 0, 0, 1, 0, 0, 1, 0, 0],
    [2, 2, 0, 0, 0, 0, 0, 0, 0, 2],
    [2, 1, 5, 0, 0, 0, 1, 1, 2, 2],
    [2, 1, 1, 2, 0, 0, 0, 0, 2, 2]
  ],
  "exits": {
    "south": "room6",
    "east": "room3",
    "west": "room1"
  },
  "objects": {
    "1": "Grass",
    "2": "Tree",
    "3": "Water",
    "4": "Rock",
    "5": "Slime"
  }
}